soybean.o	hypernym	legume.o
pork.o	hypernym	name.o
butter.o	hypernym	product.o
flour.o	hypernym	powder.o
container.o	hypernym	tool.o
valve.o	hypernym	device.o
starchy.o	hypernym	bird.o
cultivar.o	hypernym	plant.o
tree.o	hypernym	plant.o
chili_pepper.o	hypernym	fruit.o
seed.o	hypernym	plant.o
soup.o	ingredient	vegetable.o
soup.o	ingredient	meat.o
soup.o	ingredient	juice.o
soup.o	ingredient	liquid.o
black_pepper.o	hypernym	vine.o
tofu.o	ingredient	soy_milk.o
fastener.o	hypernym	device.o
oat.o	hypernym	grain.o
spice.o	hypernym	seed.o
preparations.o	hypernym	album.o
sauce.o	hypernym	cream.o
conpoy.o	hypernym	product.o
dried_shrimp.o	hypernym	shrimps.o
peanut.o	hypernym	crop.o
machines.o	hypernym	tool.o
seeds.o	hypernym	plant.o
machine.o	hypernym	tool.o
fiber.o	hypernym	substance.o
stemware.o	hypernym	drinkware.o
cream.o	hypernym	product.o
juice.o	hypernym	liquid.o
ice_cream.o	hypernym	food.o
ice_cream.o	ingredient	sweetener.o
ice_cream.o	ingredient	cream.o
ice_cream.o	ingredient	milk.o
rectangle.o	hypernym	quadrilateral.o
confectionery.o	hypernym	art.o
fowl.o	hypernym	birds.o
surfactant.o	hypernym	compounds.o
flesh.o	hypernym	substance.o
cocoa_solids.o	hypernym	mixture.o
garment.o	hypernym	fiber.o
mustard_seed.o	hypernym	seeds.o
ginger.o	hypernym	plant.o
salad.o	ingredient	vegetable.o
salad.o	ingredient	meat.o
salad.o	ingredient	grain.o
salad.o	ingredient	egg.o
salad.o	ingredient	fruit.o
cheese.o	hypernym	food.o
chocolate_chip.o	ingredient	chocolate.o
chocolate_chip.o	ingredient	sugar.o
margarine.o	hypernym	butter.o
brown_sugar.o	hypernym	product.o
sodium_bicarbonate.o	hypernym	compound.o
buttermilk.o	ingredient	milk.o
baker's_yeast.o	hypernym	name.o
